
z#########
#
#
# ###############
######## # #
# # ######## #
# # #
########################## #
# # # #
# $ # ########## #
# # # # #
# # ########### ########
# # #
# # ####
# # ############
# ############### #
# #
#############################
